"filename", "language", "Rust", "TOML", "source.markdown.math", "comment", "blank", "total"
"/home/eden/ProjectsRepo/my_ros/.cargo/config.toml", "TOML", 0, 7, 0, 0, 2, 9
"/home/eden/ProjectsRepo/my_ros/Cargo.lock", "TOML", 0, 118, 0, 2, 18, 138
"/home/eden/ProjectsRepo/my_ros/Cargo.toml", "TOML", 0, 32, 0, 0, 6, 38
"/home/eden/ProjectsRepo/my_ros/README.md", "source.markdown.math", 0, 0, 6, 0, 5, 11
"/home/eden/ProjectsRepo/my_ros/src/demo/cpu_exceptions.rs", "Rust", 4, 0, 0, 0, 1, 5
"/home/eden/ProjectsRepo/my_ros/src/demo/double_fault.rs", "Rust", 6, 0, 0, 0, 1, 7
"/home/eden/ProjectsRepo/my_ros/src/demo/mod.rs", "Rust", 5, 0, 0, 2, 2, 9
"/home/eden/ProjectsRepo/my_ros/src/exit.rs", "Rust", 13, 0, 0, 0, 2, 15
"/home/eden/ProjectsRepo/my_ros/src/gdt.rs", "Rust", 46, 0, 0, 0, 7, 53
"/home/eden/ProjectsRepo/my_ros/src/interrupts.rs", "Rust", 84, 0, 0, 15, 16, 115
"/home/eden/ProjectsRepo/my_ros/src/lib.rs", "Rust", 54, 0, 0, 5, 9, 68
"/home/eden/ProjectsRepo/my_ros/src/main.rs", "Rust", 29, 0, 0, 2, 10, 41
"/home/eden/ProjectsRepo/my_ros/src/prelude.rs", "Rust", 0, 0, 0, 0, 2, 2
"/home/eden/ProjectsRepo/my_ros/src/serial.rs", "Rust", 34, 0, 0, 3, 6, 43
"/home/eden/ProjectsRepo/my_ros/src/test_framework.rs", "Rust", 14, 0, 0, 0, 3, 17
"/home/eden/ProjectsRepo/my_ros/src/vga_buffer.rs", "Rust", 174, 0, 0, 7, 25, 206
"/home/eden/ProjectsRepo/my_ros/tests/basic_boot.rs", "Rust", 15, 0, 0, 0, 4, 19
"/home/eden/ProjectsRepo/my_ros/tests/should_panic.rs", "Rust", 27, 0, 0, 0, 5, 32
"/home/eden/ProjectsRepo/my_ros/tests/stack_overflow.rs", "Rust", 49, 0, 0, 3, 11, 63
"Total", "-", 554, 157, 6, 39, 135, 891